"BsmtFin SF 1","Bsmt Unf SF","Total Bsmt SF","1st Flr SF","2nd Flr SF","Gr Liv Area","SalePrice","Prediction (SalePrice)LR","Prediction (SalePrice)PR"
468,270,882,896,0,896,105000,119510.95064512569,117347.97953117067
923,406,1329,1329,0,1329,172000,195762.14755819223,193945.40186845543
1065,1045,2110,2110,0,2110,244000,313850.78125303827,330240.81548075675
616,722,1338,1338,0,1338,213500,189944.13083550503,182459.9171163207
637,663,1300,1341,0,1341,171500,188401.03602087268,179627.51052325737
1416,234,1650,1690,1589,3279,538000,394085.81938025984,447004.966218752
120,744,864,864,0,864,141000,108742.15429495269,108238.86140465908
885,0,1053,1173,0,1173,170000,163332.1075757203,153008.24528864308
533,281,814,814,860,1674,216000,184720.3749599621,181312.17230807306
1051,354,1405,1337,0,1337,184000,204015.87126962177,209125.35064929238
0,525,525,525,567,1092,88000,104731.32931390163,116366.6175476563
514,341,855,855,601,1456,149900,168102.43679681962,157322.64564873194
0,836,836,836,0,836,120000,101835.73552504595,103607.64971189859
1201,340,1541,1541,0,1541,220000,233386.61177141586,245843.43178002612
110,1588,1698,1698,0,1698,275000,231084.84890338627,237812.049046456
28,1794,1822,1822,0,1822,259000,247402.16571319854,265360.6990594485
578,1093,1671,1687,563,2250,320000,287650.1285361559,281805.6944115045
24,1346,1370,1370,0,1370,205000,180877.43275562898,176452.05049952085
326,58,384,744,630,1374,184500,128192.0426780449,125164.98993939983
625,235,860,860,1100,1960,216500,214194.2032215161,220562.70013748773
0,847,847,847,886,1733,185088,179401.74101061886,178035.74326250676
0,1629,1629,1645,830,2475,355000,290920.7403888281,298375.6083694695
919,801,1720,1720,0,1720,260400,253135.4625960338,258813.37816285432
0,1195,1195,1195,644,1839,221000,209803.64787206863,198879.41372985093
222,769,991,991,956,1947,254900,211730.0148671624,208777.64448552995
1414,54,1468,1468,0,1468,271500,227611.94578902406,248015.57504673046
338,702,1040,1097,0,1097,152000,144620.12008808943,134352.68236844096
899,210,1109,1155,0,1155,148000,166856.65821899162,160899.1193981985
659,381,1040,1040,0,1040,127000,147146.4175880552,140956.46358408514
1298,190,1488,1488,0,1488,260000,227853.25951388018,243235.1493848834
368,190,600,600,600,1200,149500,126797.24192719886,128617.77770750865
728,0,728,788,0,788,155000,108095.95929459542,107984.20695063625
833,659,1492,1492,0,1492,230000,217625.32379055535,216217.70690234506
1137,143,1280,1280,1215,2495,243500,297689.7872448711,318896.01548529573
687,491,1224,1287,604,1891,212500,231698.24959043117,218878.88459181634
569,678,1328,1328,0,1328,143000,186714.9094510648,179813.30819865337
1059,150,1209,1209,0,1209,159000,181288.75334340206,181210.5820278823
1014,138,1152,1152,0,1152,180500,171864.61234052732,170117.81851845662
1500,228,1728,1728,0,1728,84900,267825.2133440317,303225.29852252
49,0,1078,1078,0,1078,142125,130078.64197455606,131357.64972909057
300,482,782,1019,537,1556,172500,167450.1035750655,148455.89011218975
0,728,728,1306,0,1306,76500,136057.14484691128,114524.5378285677
540,728,1268,1268,0,1268,132000,177888.2886569997,169180.17765980837
0,1604,1604,1604,0,1604,135000,214710.82551374787,220634.69054200183
856,125,1143,1143,0,1143,136000,165534.2401517942,161012.8332967799
0,1194,1194,1194,0,1194,148000,154451.9884104044,147561.84637669646
0,832,832,832,505,1337,108000,144537.23383750685,135600.0721822141
648,324,972,972,0,972,122500,136896.41072651593,132032.58171434875
0,576,576,985,0,985,105000,99070.28460860584,92271.90539472614
0,0,0,827,0,827,107500,50641.45497164356,84255.83499032052
481,161,816,816,408,1224,132000,143627.39173543215,133894.34739615966
234,180,900,900,0,900,134800,112687.1099133254,114222.27127813127
717,415,1395,1395,0,1395,192000,198507.46604452335,196403.56623746277
0,576,576,792,348,1140,96500,112174.34276783372,106665.36170362869
0,747,747,747,0,747,80000,88755.15869041775,96326.93829316866
0,624,624,720,0,720,105900,78997.69615759213,89186.91646113148
686,0,686,966,686,1652,139000,178818.2806335599,160500.23019019092
0,346,346,1157,1111,2268,240000,195343.99316976682,199661.69188516669
0,840,840,1128,1128,2256,76500,224078.11568087235,222866.57015792036
788,200,988,1030,582,1612,128500,196034.3853504471,182513.31946095667
474,634,1108,1160,908,2068,209500,235179.44348852165,227783.85584649883
300,480,780,780,636,1416,139900,155102.12718133884,147917.57704416325
276,252,528,548,492,1040,123900,106896.21958261068,113903.31727470324
0,576,576,902,808,1710,140000,161139.81126627492,155097.33627333262
104,0,816,816,0,816,110000,95458.6110269567,101652.2607237589
1026,186,1212,1212,180,1392,100000,196391.97822979136,190968.8906847672
736,120,856,936,744,1680,114900,192604.76866456194,181191.04678064724
0,1768,1768,1768,0,1768,136500,238814.3603550853,254668.3394274729
841,198,1039,1039,0,1039,131500,151232.73617096985,146792.0465815459
371,292,663,663,689,1352,158000,144101.00436526292,143055.7709465944
267,0,720,720,720,1440,163000,148990.55882759698,146825.73787676878
438,234,672,672,714,1386,158900,149125.20786093548,147516.54989809924
1092,328,1420,1483,0,1483,270000,218527.7071095333,222056.31642318438
104,172,663,1074,0,1074,144500,111265.93400996638,100964.6959130499
739,405,1144,1144,0,1144,129000,164292.37343340434,157902.47095988787
192,564,756,1169,0,1531,127000,116528.78587584296,102265.40803795449
0,741,741,977,755,1732,178000,173046.89922167733,161257.89343392657
747,189,936,996,0,996,147000,139108.23317626305,132263.61984401668
504,506,1010,1052,0,1052,155000,142772.04129140216,134165.73829207677
870,0,870,965,0,965,159000,135302.39286536485,128103.36177171496
0,1040,1040,1044,1054,2098,240000,222515.38342046505,224914.778284123
662,186,848,848,0,848,143000,118997.42461873146,118143.30592426975
24,1390,1414,1414,0,1414,185500,187344.2347862317,184239.09307129952
0,744,744,792,328,1120,64000,120591.0073924418,114189.18407401556
94,641,735,798,689,1487,113000,153700.19141428254,147419.7831668485
0,806,806,841,806,1647,128000,169551.53433893007,165254.49658710737
0,804,804,1699,748,2447,169000,238820.7609862882,207561.0457098973
426,850,1528,1225,908,2133,257500,262951.29742438195,272630.48381458176
1406,496,1902,1902,0,1902,335000,291212.05071357655,324531.29330981587
480,0,480,540,0,540,82000,65878.27051666856,87784.76710587433
539,473,1012,1034,0,1034,169900,142146.7087052308,134640.0649732428
0,1958,1958,2048,0,2048,170000,274539.3641162065,303560.4714762163
353,60,747,1687,0,1687,160000,175687.01538324053,144524.51459500668
0,2002,2002,2018,0,2018,378500,274592.6874357141,307554.03903632157
42,1026,1068,1264,0,1264,169000,153897.3840703359,139199.32110864858
0,1430,1430,1430,0,1430,173500,189137.5629381826,187212.3180359152
0,1344,1344,1344,0,1344,166500,176497.90442382277,171929.87109937356
334,212,546,546,546,1092,83500,113786.39216314742,119802.38944399968
150,0,630,630,0,630,75500,71099.98846096896,88470.51474198898
0,546,546,546,546,1092,88250,106017.60472898968,115673.78295655249
1341,54,1679,1803,0,1803,285000,265336.046231642,287604.34855664236
944,208,1152,1152,645,1797,231000,225526.83160874253,217967.84992181807
310,370,680,680,790,1470,185000,153838.5689950292,154633.33901452372
600,107,707,707,809,1516,181316,166180.8979368732,164121.3984248021
0,1181,1181,1190,0,1190,166000,153321.3600369873,146027.7129434257
694,284,978,1005,978,1983,225000,225023.9419612112,223133.35331563302
0,1424,1424,1442,0,1442,180500,189815.76165980412,187245.46926453564
1036,184,1220,1360,0,1360,187500,194504.08584319826,189512.74738154514
0,1362,1362,1586,0,1586,181000,198557.1877411802,189514.42414113524
0,832,832,1154,896,2050,154000,205961.6642974688,193287.98929299234
1104,1420,2524,2524,0,2524,278000,375604.6433121452,386131.70312338555
0,1090,1090,1370,0,1370,152000,163434.03671911848,146701.4295737739
381,399,780,1088,780,1868,197500,196024.01795047958,179144.19462147282
544,288,832,832,1103,1935,263435,208452.08300322318,215631.33440245868
0,1058,1058,1058,816,1874,220000,204412.48678019235,197098.52075781333
888,228,1116,1116,0,1116,167900,163642.85232753484,159483.58806141178
0,1064,1064,1350,0,1350,165000,160132.75639751204,143077.9064495539
828,174,1002,1002,0,1002,148500,145492.36560030258,141331.50141301076
726,138,864,864,0,864,76500,122837.61892099935,121406.90348547982
765,0,765,765,600,1365,125000,160627.38612251502,151450.7826977763
0,630,630,630,672,1302,112000,129164.23465724685,132912.05226084072
958,0,958,958,0,958,143750,142049.3431099409,139481.9263232246
389,466,855,855,601,1456,137900,165194.95646966476,154561.27027443892
320,484,804,804,744,1548,147000,168352.59941932443,162338.24928865783
279,576,855,855,601,1456,138000,162636.37378176855,152259.94243652988
644,220,864,1120,0,1120,148800,143117.48142152553,127783.95907998184
1767,788,3094,2402,0,2402,555000,410392.05905042845,416614.6388341228
0,1566,1566,1600,0,1600,256300,212072.5935855364,215440.415668939
986,379,1365,1365,1325,2690,398800,316099.60870046006,339651.0171331614
1232,788,2020,2020,0,2020,404000,304507.62536206614,328311.8925153238
0,1709,1709,1717,0,1717,255500,230836.3157729888,242774.20420732987
1088,625,1713,1713,0,1713,274900,256037.5665843876,267736.0627416986
1142,632,1774,1808,0,1808,324000,269205.6707263631,284290.6641535391
1170,292,1462,1462,762,2224,350000,286374.53869342146,295142.98692831007
836,522,1358,1358,0,1358,213000,198000.75167975333,194507.8293149477
881,425,1306,1306,0,1306,184500,191404.8603795441,188281.20810113722
1557,643,2200,2200,0,2200,382500,338522.17342877074,385440.21878897835
800,1084,1884,1884,0,1884,320000,274471.0761659197,280700.4239217351
0,1405,1405,1405,0,1405,173000,185463.24360261287,182678.512996858
567,197,764,764,862,1626,173000,178334.01406416972,176312.7990809317
0,745,745,745,745,1490,167800,152323.77771304402,150611.98673306656
16,1357,1373,1555,0,1555,192500,196905.9632190041,188643.65755714907
16,1330,1346,1504,0,1504,181000,190857.65118704445,182111.87800815882
16,1204,1220,1220,0,1220,180000,158645.43800127273,151670.80314321624
353,55,408,779,640,1419,184100,134157.97556620347,128324.53465504301
904,410,1314,1314,0,1314,207500,193115.61894712283,190628.93670880055
0,982,982,1007,793,1800,179000,193437.6758276843,185015.11278528153
913,264,1177,1223,1089,2312,245000,270527.22691194614,276706.1974540819
772,220,992,1022,1038,2060,214000,234299.12819779784,235599.4801043867
1163,89,1252,1268,1097,2365,337000,285450.85914147855,300344.82120138407
854,371,1225,1276,1336,2612,336000,297816.15858356137,316351.551570341
0,1264,1264,1277,1067,2344,265000,257331.68266959538,261235.81720941112
816,254,1070,1094,967,2061,260000,240180.19482673236,239078.91533789638
0,1468,1468,1468,0,1468,244600,194722.52832824856,194240.18262623693
0,1696,1696,1696,0,1696,275000,228232.3206686445,239464.1639877922
1294,408,1702,1702,0,1702,275500,259212.3936558881,280834.70768315415
379,1043,1422,1432,0,1432,245000,197643.94741504392,189758.39667319885
27,1191,1218,1218,0,1218,208300,158607.35072321678,151444.47297709982
936,364,1300,1314,0,1314,229456,193015.67592018965,190690.38125116023
1121,645,1766,1766,0,1766,370878,264594.6983821643,278890.00767006056
765,252,1017,1026,981,2007,310000,231104.4582779071,230461.46472382967
682,218,900,909,886,1795,270000,203834.5283480626,199380.560870744
812,280,1092,1112,438,1550,241000,197627.17502415663,184312.35814373137
1430,222,1652,1662,0,1662,291000,255893.77989300317,283925.9105531833
0,1114,1114,1114,0,1114,159000,142694.1665365813,135886.52073114252
20,1434,1454,1434,0,1434,189000,191396.733728054,190263.89466688762
0,626,626,626,591,1217,120000,121632.89694593527,124778.54443650265
544,480,1024,1020,0,1020,124100,141773.29678738408,135354.97858582353
594,270,864,1144,0,1144,131400,144034.53644020794,127655.54601192071
0,612,612,612,612,1224,164500,121375.43094480669,125741.83795704687
294,318,612,612,612,1224,173733,128213.82467427486,130021.36555821367
649,321,970,983,756,1739,172500,202557.91899274808,192907.51488733012
121,1619,1740,1740,0,1740,241600,237513.56365593302,246081.93343632598
0,1442,1442,1442,0,1442,185000,190901.23621925604,189414.11882212711
859,216,1107,1107,983,2090,200000,245646.63639515586,246967.95233306446
560,150,752,1285,782,2067,206000,215398.69821495426,191436.8564388507
593,130,723,735,660,1395,162000,156637.15407419496,149963.13642100984
0,932,932,1271,1369,2640,256900,262678.607755051,271274.07794848474
686,664,1350,1334,0,1334,167900,191949.29500008898,186000.91674675065
144,379,1650,1680,0,1680,213250,218150.69454776426,230222.7925495956
643,167,810,810,855,1665,227000,186262.4587382647,182530.72500097193
648,216,864,864,0,864,130000,121023.35119685472,119544.03286506946
338,121,925,925,0,925,117500,118944.9667199033,118004.12611335958
0,1584,1584,1776,0,1776,110000,228411.74724164692,230656.99613674555
196,975,1516,1516,0,1516,167000,203498.28688595654,202528.14074155627
310,491,1313,1313,0,1313,153000,174940.74538538745,172881.70277016392
998,294,1292,1292,0,1292,145100,192068.64313784192,191656.35384761053
991,50,1041,1041,0,1041,124500,155015.65811040124,152391.50820488718
568,640,1208,1576,0,1576,174500,201615.25413792845,183301.9041326151
280,140,420,708,0,708,82500,72168.38350852483,83723.14159393079
1024,481,1505,1505,0,1505,149500,223978.59978494418,228470.0741921046
504,546,1050,1050,0,1050,128900,145010.8697166111,137654.72699896686
120,736,856,1112,556,1668,140000,177414.73083106766,156976.20501719415
1312,141,1453,1453,0,1453,187500,223034.85024072393,237920.8245009809
585,630,1215,1215,0,1215,155000,171145.4245833676,162770.31984047894
172,727,1382,1382,0,1382,153000,182110.55353666318,180945.79243278754
155,295,1200,1200,0,1200,144000,152769.8317010377,153158.69391379436
1213,84,1297,1297,0,1297,153000,197804.3731676622,203994.72404834593
428,0,608,1319,0,1319,123000,138421.92808074158,112212.15065254929
0,1005,1005,1005,0,1005,115000,126674.13423349729,121616.42639903803
700,93,793,793,0,793,113000,111797.79609993314,113208.38272202323
440,538,978,1014,685,1699,95000,194779.54160562548,181661.2917707514
699,0,699,801,726,1527,152500,169033.1508101796,158985.6233792223
390,810,1200,1200,0,1200,129900,164405.16367166425,154920.1913595358
0,660,660,808,704,1656,135000,143650.31788702644,140053.0272395714
0,768,768,792,0,792,109500,93921.63408184068,98218.46802802777
0,560,560,930,760,1690,156500,158487.03163301098,150142.08709285661
315,420,840,840,534,1374,105000,154662.09412777328,145170.93476317552
0,630,630,725,0,725,78500,79792.86416689784,89522.23040947223
0,1248,1248,1248,1296,2544,190000,273483.6640571619,289631.70715082716
384,996,1380,1380,0,1380,154000,190720.70383206278,182368.5284755308
1270,208,1478,1478,0,1478,157500,225732.25618636963,239490.92297054757
0,160,160,1142,0,1142,113500,87590.73656009707,90853.82463623983
0,0,0,1040,0,1040,90000,69101.8734238497,90128.82569305447
433,0,528,1183,0,1183,138000,122626.14588603305,101423.1369299562
941,0,941,941,0,941,145000,139155.38863726042,136657.26774480994
0,894,894,894,0,894,109500,110360.15638356774,109191.93981449041
0,240,240,810,496,1306,130000,106158.9777042697,111360.50924357689
0,600,600,1101,600,1701,94550,162004.08315230563,143240.7685694464
0,651,651,707,682,1389,135000,137961.32187986723,137197.43580312052
384,384,768,768,560,1328,129500,148777.44187839545,140878.26463584843
0,861,861,861,0,861,80000,105510.05486061568,105935.56887429507
312,408,720,720,564,1284,110000,140390.9263383824,135167.45170803575
0,917,917,1090,917,2007,160000,207340.8768117751,198902.38875627736
216,700,916,916,826,1742,168000,189423.6945912849,182864.35183391464
247,310,1022,1022,0,1022,85000,131092.9057556859,129558.47318967553
1088,0,1088,1188,561,1869,124900,216358.6204151141,207559.3235741636
0,972,972,1044,0,1480,119000,111432.14448032124,106768.27296336928
495,225,720,720,0,720,34900,96300.5159035356,102837.24004053566
0,698,698,786,390,1176,134900,122611.74198142505,115832.35527922845
405,740,1145,1301,0,1301,100000,170190.86524470773,155376.5081044985
0,844,844,1445,689,2134,214500,214161.52211363203,187773.97351487284
0,728,728,1136,883,2019,167500,197015.61782601947,183822.9652096188
299,611,910,916,910,1826,155000,198193.047982527,194377.80703366402
0,672,672,1272,672,1944,179900,187338.26987961278,164192.3558110203
0,1040,1040,1088,1040,2128,62500,225128.70131010268,225242.8584535757
152,628,780,848,0,1208,103000,89301.3546727235,88797.6220471027
0,483,483,741,686,1427,123000,131119.84570622563,131539.03077422598
749,46,858,892,0,892,70000,124919.27353024528,121133.87704026398
276,160,698,754,649,1403,116000,146304.8159196587,141538.90137304593
226,192,918,918,765,1683,172500,180608.3772399088,176725.87272510695
450,414,864,899,0,899,130000,119451.30445172696,115767.92646333222
456,0,456,1034,0,1034,149900,106687.03870937352,92975.16698373824
685,173,858,858,0,858,134900,121002.12873315583,119763.98508675268
672,168,840,860,0,860,137000,119787.61348214182,117916.55873488187
0,0,0,1733,0,1733,139600,129163.23486694288,130812.19372034335
0,0,0,1383,0,1383,122000,98829.21393608775,106962.76069840766
0,1436,1436,1689,0,1689,127500,211946.56328016607,205644.42352120182
0,0,0,845,0,845,84000,52201.490333801834,84593.09320942315
70,0,520,1338,0,1338,156500,124213.90708027611,103835.6149004928
1441,55,1496,1496,636,2132,316600,286874.113378325,307023.7573223839
513,227,740,1006,769,1775,213000,188632.3865323554,173178.7656948861
0,0,0,1535,0,1535,118964,112002.84588320198,116676.06540438524
0,0,0,1513,0,1513,113722,110096.13599611967,115201.21926985697
20,846,866,866,902,1768,212000,184030.96556888463,182562.74114084276
24,1474,1498,1498,0,1498,237000,199689.94775374598,199711.69163649582
0,704,704,704,718,1422,173000,143983.41179683618,143827.1332092839
1518,0,1518,1644,0,1644,275000,248299.85562746422,274354.03377226595
385,70,799,827,834,1661,212000,176441.6496554204,172496.41619511505
746,244,990,990,0,990,138000,141821.38522461554,137182.60088450866
0,831,831,831,829,1660,195000,172164.0475345658,169302.87674525607
666,278,944,944,896,1840,230000,210006.37084751535,205806.90190710366
616,424,1040,1040,0,1040,124000,146146.24435551395,139636.37557288716
532,364,1040,1040,0,1040,150500,143007.9179361954,137420.10387308485
460,404,864,864,0,864,133500,116650.50078481383,115186.81041240497
660,108,768,768,0,768,133900,107193.08305967384,109964.6568752476
0,1068,1068,1068,1116,2184,254750,231598.68346857,237182.16267124625
904,536,1440,1476,677,2153,313000,272787.7573959087,269380.0926186892
0,944,944,944,926,1870,211000,197086.96255984931,194941.02681975527
1246,216,1462,1513,0,1513,220000,227242.55578157303,238349.22061907977
690,814,1504,1504,0,1504,203000,216062.83957736366,212014.13617649698
1360,462,1822,1828,0,1828,279500,278904.28786674654,307441.3798264909
1111,306,1417,1417,0,1417,210000,213068.60203143855,218660.70712175593
0,880,880,909,807,1716,191000,179993.22934801088,173706.17609340348
0,1630,1630,1630,0,1630,213000,218532.1176227404,225882.66482527653
0,0,0,1126,0,1126,108000,76555.37570971696,93576.1748772122
0,0,0,495,1427,1922,198500,144192.1400615189,225079.0468802645
631,410,1041,1125,0,1125,125000,153922.27979160054,143589.34752034067
0,0,0,1088,441,1529,98000,111065.17708553851,122305.07067981745
0,0,0,944,0,944,82000,60781.68482567227,86986.59302867972
626,94,720,854,444,1298,122000,149021.52592349143,134284.12419489666
264,712,976,1160,448,1608,137450,182902.81070655774,161660.56236438284
0,600,600,628,600,1228,137000,121009.82058003565,124410.98164502926
428,300,728,976,332,1308,160000,145871.26815678028,127367.11026494174
713,163,876,964,0,964,163500,131925.75379637803,124779.98792138771
275,429,704,860,704,1564,174500,162700.07310408814,152638.43405624395
0,1092,1092,1152,0,1152,158500,144660.88339514082,135433.27618559377
471,90,561,561,668,1229,137000,129635.61291107183,133397.51181610618
0,561,561,561,668,1229,121000,118680.22703835243,127774.6401226681
454,118,572,1182,800,1982,208000,195040.00748497434,173976.32670404162
803,581,1803,2365,0,2365,315000,307897.2668751743,314241.86044084444
0,760,760,928,928,2168,123000,172873.92602000883,173432.56202558498
0,1013,1013,1013,0,1526,85000,108280.57874827941,106882.46761906875
111,354,819,1344,0,1344,137500,144508.17735662317,125809.61817178804
1115,526,1641,1641,0,1641,316500,246083.5426486122,257285.64911258558
16,1450,1466,1466,0,1466,201000,194800.7402632788,193768.74054103123
1640,338,1978,1978,0,1978,425000,307824.7846661424,361253.1605079429
532,476,1008,1008,0,1008,139500,139489.28882613665,133175.4517199895
866,338,1204,1204,0,1204,162000,176064.73985116102,171747.66873310023
883,341,1224,1224,0,1224,165000,179399.61264410985,175537.86291604844
462,0,462,526,462,988,91000,102764.12014226272,109302.73196926047
510,354,864,874,0,874,130000,118680.17922798594,116539.62304160098
0,546,546,798,546,1344,97000,127858.09979920539,121995.13475710222
273,0,546,546,546,1092,88000,110121.92786366641,116106.68127962266
720,0,796,796,0,796,131900,112078.75868504794,112633.98457310344
625,208,833,833,0,833,112000,115932.2188405518,115728.90144515036
732,64,796,796,566,1362,143000,161501.43414411563,151428.6601466757
330,294,624,624,663,1287,130000,135186.6520117744,136428.43401035081
1567,0,1567,1567,0,1567,196000,245721.00627831768,279195.22521821357
828,115,943,943,695,1638,192000,196397.4583788049,186837.19776305457
138,778,916,916,720,1636,173000,178522.94117000737,169232.77248799696
450,898,1348,1384,0,1384,177900,190672.7954195878,181005.52329304282
504,332,836,851,858,1709,185000,188407.82688146774,183740.74857331475
767,461,1228,1228,0,1228,189000,177289.36199420132,171319.23191084736
16,1152,1168,1168,1332,2500,355000,265183.9759397125,283007.0804377143
0,1488,1488,1488,0,1488,133000,197661.98379670433,198003.0037326421
588,606,1422,1422,0,1422,175500,199763.1104472417,196275.1845551519
747,513,1260,1260,0,1260,181900,181527.29389138578,175373.39994712395
1206,656,2048,2064,0,2064,235000,307874.82650856953,333039.3359739998
864,469,1782,1782,0,1782,220000,257275.147522894,268884.33239713364
890,273,1211,1211,0,1211,161000,177256.95227477746,173692.56456151736
0,896,896,896,896,1792,133000,187460.6225401405,185115.97670022352
119,132,864,864,0,864,123000,103676.54529264511,108501.0577083285
600,264,864,864,0,864,111250,119906.87875122725,118410.1634238037
387,96,483,483,504,987,85400,102159.57344264441,112934.08437244545
358,125,483,483,504,987,89500,101485.0380067445,112762.12496492942
350,280,630,630,672,1302,111750,137305.17957328042,138109.18164910068
378,677,1055,1055,0,1055,148500,142814.99341395297,134972.15651551902
340,524,864,892,0,892,110000,116286.04134521361,113198.72041967085
1280,402,1682,1742,590,2332,426000,311723.14054114633,327071.25233852235
1330,122,1452,1476,1237,2713,446261,331424.1754382331,363439.0728571243
1420,430,1850,1850,898,2748,390000,360873.0680283211,392696.47184260737
1249,165,1414,1414,917,2331,379000,294444.2154288668,309705.5240614925
40,908,948,948,1140,2088,250000,216949.66187885683,224896.43136088646
1540,162,1702,1702,0,1702,367294,264934.3149397288,302235.145250613
1204,596,1800,1800,0,1800,370967,271522.33961576986,290575.67307717557
846,496,1342,1342,0,1342,234250,195881.78573116113,192405.03981684364
1073,342,1415,1455,0,1455,195000,215357.52771437843,218608.2612509619
1087,306,1393,1576,0,1576,219990,224843.37876175359,225097.53712965277
16,1330,1346,1504,0,1504,191000,190857.65118704445,182111.87800815882
0,1266,1266,1266,0,1266,159895,165034.0280968452,158874.7023590919
0,847,847,847,1139,1986,213000,201089.29649528512,211861.67386202182
724,64,788,788,702,1490,184000,171797.7058083433,163973.2280141074
655,490,1145,1145,1053,2198,250000,252750.32545604467,254728.77310141895
0,1519,1519,1533,639,2172,291000,258207.5794823839,256866.16033823916
1660,322,1982,2006,0,2006,350000,310957.9197617227,366127.69141145214
228,0,1080,1108,1089,2197,287500,231769.5508014351,239131.0277901167
0,1580,1580,1580,0,1580,235128,211183.47895160093,215844.89494692368
1096,482,1578,1578,0,1578,240000,236382.32091324896,245275.25593840738
729,226,955,955,919,1874,297900,215060.03739320353,212003.31487339793
0,1026,1026,1026,932,1958,250000,209653.059359601,206756.29980261734
0,1660,1660,1660,0,1660,256000,222941.30082542403,232011.25182357902
680,400,1080,1080,0,1080,141000,153513.7852199288,146943.37551547008
80,200,835,835,861,1696,188000,172790.5570322862,175899.71880967863
80,1095,1175,1175,0,1175,146000,153520.2931247505,145509.87620539643
362,392,754,754,855,1609,182000,171495.96765114443,170541.79343099735
472,355,827,827,850,1677,190500,184354.95498300175,180368.2438083847
397,439,836,844,893,1737,175000,188312.59801412356,185441.3622739445
165,598,1604,1617,0,1617,193000,212757.5848294102,220521.46267950488
300,899,1199,1199,0,1199,153900,162164.80506268993,152677.15211154218
890,0,890,890,0,890,115000,130473.525219219,128596.8763828311
489,375,864,864,0,864,119916,117325.03622071378,115842.11715772562
704,226,930,1364,1319,2683,290000,282707.0332186629,283594.9818986524
510,90,600,624,628,1252,160000,134925.8695589573,133687.65937102385
600,72,672,684,720,1404,170000,154447.65531878333,150806.7693565049
681,177,858,872,917,1789,223000,200729.12363643877,197815.67039591458
813,147,960,962,645,1607,200000,194434.3569911708,183651.1909123385
128,0,970,1469,924,2393,345000,240035.68576763774,226552.15447840712
660,572,1232,1232,0,1232,162500,175388.44992784792,167861.3467648089
1044,0,1426,1671,0,1671,290000,230924.54786711413,229677.9625287317
656,602,1258,1258,0,1258,145000,179116.70266637148,171608.67559659627
0,1625,1625,1625,0,1625,140500,217797.25375562644,224868.77855461696
260,196,912,925,0,925,135000,116429.00206667329,116383.16135131172
231,1497,1728,1728,0,1728,142600,238308.47306275583,242604.12269435136
442,459,901,943,933,1876,185000,205288.117193455,201027.7823276074
776,344,1120,1128,0,1128,155000,162318.99009794337,156174.22114106786
0,1114,1114,1114,0,1114,140000,142694.1665365813,135886.52073114252
0,1252,1252,1252,0,1252,142000,162976.40926892616,156617.79230077704
0,270,270,729,0,729,52000,58430.047502783156,79320.96324980423
851,140,991,1077,0,1077,118000,151864.14375871563,143710.40590916213
120,228,348,453,453,906,87000,80836.27760881625,102859.31207100855
280,752,1032,1032,220,1252,119000,156013.89894844923,142342.38331941245
288,700,1362,1362,0,1362,163000,182765.84023335073,179438.61266416413
0,1319,1319,1537,0,1537,174000,191717.3466966142,181230.536978783
148,572,720,882,0,882,116000,102269.66877477817,99364.53840094231
500,456,1152,1152,0,1152,137500,158296.81761487623,152010.71770221644
0,998,998,1790,0,1790,180000,194286.8807545014,167229.11690637114
852,100,952,952,0,952,139000,138701.96315197684,135478.0202489271
442,390,832,832,384,1216,118500,144445.77512948596,133877.9103035247
0,672,672,672,0,672,86900,77732.2006837086,91464.69081393733
0,892,892,1254,182,1436,139000,157041.5798412003,134238.55657281732
319,539,858,858,858,1716,171000,186038.1275441147,181775.35761393135
697,384,1081,1081,0,1081,148000,154056.17531784464,147642.03866166173
520,188,1027,1027,0,1027,125900,139378.657680658,134722.50698917772
673,181,854,854,424,1278,127500,156481.0623165894,144813.9573385924
370,398,768,1024,564,1588,150000,170981.8599296159,151660.29082632816
0,680,680,764,0,764,73000,86188.14789449611,92541.66987096738
104,516,789,789,0,789,115000,95956.89686837804,102190.3438922207
308,620,928,928,0,928,112500,122521.26220605207,118452.53288429932
0,876,876,876,540,1416,153900,154004.29057942703,143735.63599460828
0,572,572,884,656,1540,129400,146308.88173191366,137273.64638761964
0,1237,1237,1521,1254,2775,325000,292880.54916553834,295429.09893347695
0,723,723,723,363,1086,55000,116344.73956279198,113609.65642518346
0,1050,1050,1050,745,1795,131500,197150.4736069946,187744.23183086608
0,0,0,882,0,882,97000,55408.229689349384,85382.52428035077
0,672,672,1195,473,1668,108000,163606.19420190534,139792.73987489287
175,849,1024,1144,594,1738,153000,194855.93366348528,177033.36098587167
521,460,981,1014,658,1672,164900,194530.01907832362,181134.9072968422
0,949,949,949,0,949,119000,118443.65892182113,115070.87412329085
0,992,992,1013,0,1013,113000,126583.52943485233,120754.22463456457
0,0,0,808,0,808,81300,48994.75097825428,83933.70684198842
0,1078,1078,1128,445,1573,162900,179882.67387023373,164137.2121102401
0,952,952,1022,752,1774,129900,189413.99693999585,178522.86138033072
0,611,611,751,611,1362,128000,133276.3449805455,129456.61143270513
329,697,1026,1133,687,1820,184000,205577.30814316886,189574.57185082245
0,768,768,768,0,768,93850,91841.58693229631,97900.15814601316
0,1040,1040,1040,0,1040,127500,131818.1813032949,125983.63589043936
121,647,768,788,448,1236,127000,134792.6608184661,126852.55812401077
0,756,756,756,713,1469,135000,151197.38819891872,148210.4701481421
758,234,992,992,0,992,145000,142394.448882868,137808.9343924075
702,192,894,894,0,894,130000,126688.5659008693,124232.93545168944
221,852,1073,1073,0,1073,120000,141808.7080446567,133770.98151874723
104,0,1060,1126,0,1126,152000,135033.02856981696,132226.6582060166
336,240,576,864,486,1350,152400,138059.36705476785,124720.63760352285
392,768,1160,1156,866,2022,192000,232460.97160937532,225041.1159403865
226,96,1385,1363,0,1363,241500,177129.89214553506,180574.2092279091
0,570,570,617,462,1079,125600,106417.76565183236,110938.27413851164
0,1163,1163,1163,511,1674,185000,193699.55121953296,180455.05631543513
870,639,1509,1509,0,1509,159900,220984.47511558057,220834.22950043285
969,148,1117,820,527,1347,107500,185108.55267346563,187921.63492780156
236,0,616,616,495,1111,95000,114297.45906655621,115927.52292078017
1085,390,1475,1532,797,2329,262280,294248.46481693775,299522.88652577676
779,298,1077,1093,1721,2814,260000,304289.0996521022,352533.20627428225
355,457,812,1101,1099,2200,225000,225820.8654531505,222027.97641322232
0,628,628,628,728,1356,177439,133670.6966485092,138565.2975787444
2085,186,2271,2276,0,2276,475000,361671.7803998459,468942.2111887684
50,499,1080,1080,1017,2097,228000,221671.0717050886,228940.9342798354
361,602,963,963,829,1792,231500,199961.25681119706,192349.29130443075
595,390,985,985,0,985,149900,137574.28512229855,132118.90243339882
390,474,864,864,0,864,127000,115022.31180160714,113637.79785843496
0,1777,1777,1795,0,1795,230000,241697.15067804855,257966.95485738033
735,257,992,992,873,1865,235000,216694.3971592472,211755.9796298661
0,1257,1257,1290,871,2161,230500,241234.8194968783,236598.0220621593
252,901,1153,1153,878,2031,222500,229551.11751209246,222496.05104114691
0,1128,1128,1149,1141,2290,255900,244380.13020930107,250443.83107051637
0,798,798,798,842,1640,183000,168428.32633296025,167214.39087610564
686,162,848,848,0,848,136500,119555.6608415452,118695.62105908387
24,1327,1351,1361,0,1361,193000,178951.63637290613,173745.73763763276
697,151,848,848,0,848,149300,119811.5191103348,118949.16903804411
697,151,848,848,0,848,141000,119811.5191103348,118949.16903804411
662,186,848,848,0,848,149000,118997.42461873146,118143.30592426975
0,796,796,796,0,796,85000,95956.82458813442,100138.05698238117
609,483,1092,1092,0,1092,123000,153626.0096751783,146272.82418337325
830,136,1256,1256,0,1256,147500,180484.5190721029,177005.4432432267
1033,94,1127,1127,0,1127,135000,168632.23001468513,167045.52175951758
368,541,1029,1117,0,1117,147000,145400.8593942253,135578.59914315538
288,396,684,684,714,1398,160500,147399.90474942315,146304.70831637763
0,416,416,1204,0,1204,100000,108402.05209751417,95724.62462420622
468,396,864,864,0,864,98000,116836.57952575176,115366.8453147618
41,823,864,864,0,864,67000,106904.62672819084,106880.48426362709
210,570,780,936,780,1716,135900,178872.9529158175,168309.95034327672
156,516,672,810,672,1482,140000,150925.89769917325,143363.74730053317
378,342,720,1052,720,2192,179500,168050.94541010342,156167.41220289614
0,1228,1228,1424,0,1424,168000,176436.1144280581,163907.81973194808
0,612,612,990,1611,2601,189000,239772.0151674489,277824.97756997484
0,776,776,851,651,1502,149000,155322.25409250965,146572.66916933408
192,536,728,1968,1479,3447,381000,324679.86044831097,297214.46658259677
435,397,832,1218,943,2161,263400,225655.40170423593,210907.4998530847
299,555,894,919,0,919,126000,119152.53742926678,115524.32245980427
0,796,796,796,0,796,55000,95956.82458813442,100138.05698238117
538,278,816,816,0,816,120500,111410.07538466461,112145.38135445764
330,821,1151,1151,804,1955,165500,224728.04401403456,215043.305612182
0,173,173,825,536,1361,89000,106847.492173106,115720.55646467587
1480,120,1600,1652,0,1652,392500,253054.2703175828,281626.843348149
1476,120,1596,1648,0,1648,294464,252373.33985342263,280533.1561909962
1036,482,1518,1537,0,1537,294000,227815.06794423657,232649.03623895775
1513,125,1638,1646,0,1646,293077,255593.39073985294,288463.5301080561
770,150,920,920,860,1780,264966,205812.0716430633,200880.8553944975
0,1495,1495,1495,0,1495,150000,198690.79321066386,199330.1308063702
0,1092,1092,1092,0,1092,146000,139460.76552127994,132849.74496014218
785,328,1113,1160,0,1160,152500,164879.59588554857,157236.32183826383
358,188,546,546,546,1092,98000,114344.62838596114,120039.41498618826
534,282,816,816,0,816,128500,111317.03601419565,112060.86049295604
641,175,816,816,0,816,130500,113805.83917424019,114332.71977033422
816,0,816,816,0,816,138000,117876.31163225698,118039.8603111732
638,207,845,845,0,845,134500,117998.27007564937,117274.89767286566
660,323,983,983,767,1750,160000,204540.6683050163,195668.40503957277
871,52,923,947,767,1714,180000,202710.1758414307,194255.63591054664
0,1237,1237,1253,0,1253,176000,162158.51576728054,155056.65040442234
0,938,938,957,1342,2299,204000,233512.0001957895,254001.02212762678
0,384,384,812,670,1482,163900,129931.66343575408,129785.42142716778
0,903,903,910,732,1642,168000,175037.77601111526,166963.40204753552
550,752,1302,1128,0,1128,154204,168037.61954535032,166039.56452475092
986,163,1149,1164,1377,2541,349265,290111.0403949888,315105.2249808471
1101,1559,2660,2338,0,2338,591587,367615.86171340605,374808.55703007017
797,815,1612,1612,0,1612,319900,234424.70226706943,234584.37735258276
945,474,1419,1419,0,1419,392000,209501.41370382247,209745.56280272244
256,1028,1284,1284,0,1284,174000,173634.0577284685,164564.90814367446
1328,201,1529,1664,0,1664,213000,246277.20371891867,262238.5960253995
156,692,848,1118,912,2030,195000,208806.54030739784,197159.02885703178
315,114,539,1040,685,1725,197000,166747.10115480365,149179.01009750733
384,143,702,1041,702,1743,175000,179190.870701802,161484.76680554415
0,858,858,872,0,872,123000,106282.49737758152,105950.5556381509
930,475,1405,1337,0,1337,177000,201201.43031293587,202634.1492421618
0,672,672,672,546,1218,113700,124536.17418026109,124193.05948222544
0,630,630,630,672,1302,106000,129164.23465724685,132912.05226084072
120,958,1078,958,0,958,128000,129794.0920597078,128426.06972869461
556,248,804,804,744,1548,155000,173841.92227699276,167118.45916707788
632,423,1061,1055,0,1055,142500,149035.46414023763,142647.28482428374
0,1694,1694,1694,0,1694,322400,227938.3751217989,239047.3900194225
1004,730,1734,1734,0,1734,318000,257170.16804641805,265990.21294746804
1430,564,1994,2046,0,2046,450000,309798.5509152996,345857.5493293131
0,1935,1935,1973,0,1973,395000,266652.22150346957,294234.4824871618
0,1706,1706,1718,1238,2956,342000,336865.36719510244,359548.67381396156
938,379,1317,1217,1168,2385,350000,285803.2945880988,303035.32461543364
669,226,895,895,923,1818,281500,205188.96668352385,202598.57929447282
0,1298,1298,1298,530,1828,250000,215169.58533203905,204597.33166774415
866,436,1302,1302,0,1302,204000,190468.07164659433,186961.20197521255
24,1530,1554,1554,0,1554,209500,207920.42306542216,210436.1889154841
1153,408,1561,1561,0,1561,277500,235209.5947942442,246073.33511612905
0,783,783,783,701,1484,178900,154136.994323168,149659.23669834962
0,608,608,608,850,1458,168165,141189.27188807432,150731.36046815893
0,738,738,738,757,1495,171925,152323.62705725044,151260.58456553824
0,698,698,698,1048,1746,198444,171389.69100586418,183564.29227139102
0,1302,1302,1302,0,1302,176485,170325.04794006562,164800.54294345394
0,752,752,752,752,1504,166000,153952.638069267,152075.0421907792
1300,230,1530,1530,0,1530,259000,234072.6356828718,250903.21965555238
779,56,835,1119,0,1119,188500,144422.0714200603,128245.62351375754
0,840,840,840,880,1720,183500,177858.60221757635,176490.90597775546
574,280,854,864,1131,1995,219500,215650.16937840582,223432.1974847766
1181,598,1779,1779,772,2551,384500,334077.9817690401,349219.04895115044
1282,1351,2633,2633,0,2633,466500,395764.9276010976,406431.70261650777
1048,341,1389,1411,1171,2582,322500,309774.6546621612,326694.5752283142
565,638,1203,1214,1306,2520,290000,281822.2709072224,296171.5423111045
0,1369,1369,1369,0,1369,213133,180172.22375939248,176279.96308511987
929,556,1485,1464,0,1464,282922,217009.4180119994,218499.4196737357
28,1496,1524,1534,0,1534,215000,204470.96554551757,205290.77419714676
63,1560,1623,1636,0,1636,255000,220095.37049967007,224439.58828425076
0,1795,1795,1795,0,1795,147000,242782.62523750053,260464.26994632088
0,982,982,982,995,1977,250000,208586.71580936975,208872.54024843243
0,1302,1302,1302,528,1830,221300,215586.03329936916,205096.56983530338
0,1158,1158,1158,1285,2443,265000,259313.17725412536,274443.12701988104
729,365,1094,1094,0,1094,149000,156711.13633609255,150509.89862834747
480,384,864,920,900,1820,191750,199118.54784854467,193680.38071698943
0,1349,1349,1349,0,1349,179000,177232.76829093666,172793.64133129158
1443,39,1482,1494,0,1494,215000,231384.12362761525,253610.0185394784
430,1145,1575,1575,0,1575,179200,220450.3474098996,216251.95575371274
0,630,630,630,636,1266,128000,126078.25838274887,129344.65056757565
747,0,840,884,0,884,144000,122847.15947748773,118625.90844178828
0,0,0,2020,0,2020,144000,154037.1320302441,153188.35242654098
138,405,894,894,0,894,120750,110682.79679353735,113113.80474579774
630,340,970,970,0,970,132500,136183.78801256005,131279.38376144943
417,640,1057,1057,0,1057,132000,144016.07282287086,136208.1271788065
812,228,1040,1040,0,1040,145000,150705.17350849273,145940.0078886551
599,277,876,902,0,902,125500,123900.67660168989,120289.9427074104
0,1550,1550,1550,0,1550,207500,206774.29574891727,209934.1523961142
436,320,756,769,756,1525,177000,166151.39900279942,161123.788272213
964,90,1054,1072,976,2048,301000,241522.56944055745,242799.33909407747
457,0,1494,1494,0,1494,279700,200643.5259707435,202763.8595411903
1732,270,2002,2362,0,2362,255000,344692.7439922406,404918.2250158349
1157,280,1437,1437,0,1437,218000,217078.0102602873,224889.66091967933
1632,0,2461,2497,0,2497,373000,374927.52759383194,426525.89510681806
498,652,1361,1361,1259,2620,190000,296767.67024014157,311091.35234619514
0,1594,1594,1594,0,1594,188500,213241.09777951997,218632.47096547252
836,237,1073,1073,0,1073,156000,156113.51125425848,151355.19057848927
40,1424,1728,1728,0,1728,119000,231694.26045050065,239151.75388855278
498,460,958,958,0,958,151500,131349.8155060111,126303.27310529737
311,386,864,1187,0,1187,140500,139805.0615683549,123764.56771102195
700,264,964,964,0,964,137500,136930.14035523002,132539.91714571463
1386,206,1592,1652,0,1652,200000,250385.41197402813,272928.10558063514
594,331,1144,1429,0,1429,181900,183818.8296197159,168713.53785287088
0,0,0,1224,0,1224,101800,85048.9015703564,98170.88862439927
144,226,370,442,228,670,64000,62480.498300695544,90578.96598219061
368,710,1078,1150,0,1150,144000,152202.91022513778,140725.61746671918
220,708,928,928,992,1920,137000,205510.18673079016,205279.72394568313
0,1560,1560,1560,0,1560,126000,208244.02348314517,211894.75541856122
460,414,874,874,650,1524,144000,173839.24458636617,163368.78405015508
908,100,1008,1008,0,1008,131000,148234.9896502184,144778.72626140833
288,765,1053,1053,0,1053,142100,140427.66203155593,132621.22218044952
846,210,1056,1056,0,1056,139000,153847.57253224347,149326.52277150704
668,525,1331,1721,0,1721,174850,222790.4539299118,209967.3154478717
586,462,1048,1048,0,1048,135000,146624.2312643791,139767.38663251334
1237,420,1657,1657,0,1657,163500,251272.80782267996,268633.07566155575
408,456,864,1154,0,1154,142000,140574.8920257117,123868.1810351604
0,1560,1560,1560,0,1560,128600,208244.02348314517,211894.75541856122
643,365,1008,1008,0,1008,134500,142071.13135665015,136361.93996912966
384,0,384,1360,0,1360,130000,128924.40558443536,105323.52410465735
150,1040,1190,1040,500,1540,115000,187213.5606148964,177376.42901286721
377,551,928,928,0,928,132000,124126.19134664156,119997.1472494617
0,925,925,1000,544,1544,138000,168048.99007219178,153418.349708874
1030,55,1151,845,436,1281,128500,182400.90177089686,186281.67808483445
196,844,1040,1168,678,1846,143000,205589.91509022203,188956.79041157817
625,545,1170,1170,0,1170,140000,165462.0434840317,157608.34294120182
110,312,864,864,0,864,125500,104873.80003096117,109580.23591862846
0,967,967,967,0,967,99900,121089.1688434313,117114.34366265284
130,550,680,680,494,1174,135000,124278.21462249848,122412.45309324909
196,322,728,914,728,1642,145000,167319.8732451745,158059.98044629185
0,662,662,1422,915,2337,90000,220565.86299520856,200304.64036239256
370,779,1149,1149,467,1616,152000,196476.32538005032,180517.3945797426
0,718,718,1576,978,2554,159500,242690.32264789563,219940.55691387458
324,588,912,912,336,1248,87000,149344.30054181092,136735.7539745623
317,212,756,916,144,1060,136500,121794.93778528756,112052.5138685863
375,360,735,869,349,1218,131000,137244.34852575895,124068.64552589333
52,809,861,861,548,1409,126000,153694.9832996256,143604.23334979
48,624,672,899,423,1322,132000,134782.67364412747,121690.14121584447
0,764,764,1060,764,1824,180500,182398.88495288684,167921.1912248508
0,698,698,698,698,1396,153575,141387.1438926895,141170.90135531104
224,816,1040,1226,592,1818,169500,203895.91686138057,183864.82408553187
0,637,637,1108,0,1108,139400,113409.07892371889,99736.13593518065
354,224,976,976,976,1952,212300,211036.32836248068,212588.01084290387
0,771,771,866,504,1484,50000,139370.95135746035,129586.7322282417
485,187,672,778,504,1282,108500,141403.76710652845,131124.40140993163
513,348,1005,1005,0,1005,115400,137421.93385667025,132467.26385097808
903,126,1029,1029,0,1029,118500,151205.11867901077,147539.9892630628
249,30,1040,1040,0,1040,123000,131350.13054806343,129289.47329985848
748,20,768,868,0,868,119900,117906.81233309233,113277.00878951537
492,402,894,894,0,894,129000,121803.99895124919,119042.16307685719
216,261,912,912,0,912,129000,114451.61631626773,115815.9758262456
258,422,680,798,504,1302,165250,138339.58859456977,128798.20229239318
190,95,1158,1176,0,1176,137000,147959.3449623278,146631.66507691343
1219,424,1643,1824,0,1824,302000,264483.5340804643,278397.0257888287
587,486,1073,1630,0,1630,130000,198596.23803824128,174955.23690304992
491,497,988,988,638,1626,154000,190286.53711953253,177578.55782063428
0,0,0,943,0,943,80000,60695.01619444127,86957.99969569067
1440,0,1440,1440,0,1440,150000,224101.4640412342,244695.33697266722
1080,0,1080,1080,400,1480,136500,197106.34753902393,188372.58302848932
0,0,0,1340,0,1340,120000,95102.46279315412,104435.02202770924
0,1105,1105,1105,717,1822,228500,202833.77237619407,192709.65748125396
700,0,700,1122,1121,2243,225000,230797.3628764415,223679.8938321229
0,1643,1643,1651,0,1651,250000,221136.11272708475,229104.82818991976
925,349,1274,1274,0,1274,203000,187725.16470517335,185247.3481147969
1065,92,1157,1180,882,2062,277000,251385.52542463396,252306.4566761494
51,0,966,1743,0,1743,279000,181943.46638418405,160992.6272225257
550,472,1022,1022,0,1022,139500,141965.584821166,135415.61628271086
334,322,1200,1200,0,1200,177500,158627.8360693215,155813.25162195798
841,144,985,985,857,1842,217500,216759.586051827,212063.57230934507
0,840,840,840,828,1668,180000,173401.08093219038,170205.24013354542
138,276,882,882,0,882,112500,107956.71755539413,111654.09547027756
1412,261,1673,1673,0,1673,270000,257694.84465546132,285452.636320592
0,1459,1459,1459,0,1459,192000,193399.77336744347,192561.1288953112
654,325,979,992,940,1932,213000,219769.74079185122,216522.04246689595
1198,333,1531,1531,908,2439,275000,309682.28387722943,325213.82359514514
915,426,1341,1341,0,1341,246900,197339.74209832778,195493.06730093615
0,738,738,738,738,1476,179400,150694.917356821,149163.39081048692
698,420,1214,1214,0,1214,140000,172837.14759937915,166834.3112124134
520,440,960,960,0,960,94750,132155.47759043588,127105.43449638424
130,666,901,901,450,1351,122000,152123.75111521233,141414.91978054575
816,0,816,816,0,816,118500,117876.31163225698,118039.8603111732
751,392,1143,1113,0,1113,148000,161824.459834458,156892.85328025467
0,1125,1125,1125,0,1125,155000,144310.86704423197,137433.61448215644
4010,1085,5095,5095,0,5095,183850,821064.7464278312,131289.48061260046
552,342,894,894,0,894,110000,123199.58950828349,120485.82163161985
0,560,560,796,550,1346,112000,128871.90678015018,122873.15570032096
544,224,768,768,0,768,125000,104494.94131607417,107784.13476602483
319,971,1290,1422,0,1422,136500,187421.52377638523,174419.88026955343
113,538,651,759,539,1298,146500,132838.2693848166,126699.78929587023
246,285,531,567,531,1098,148500,111369.18168809763,117195.41273951181
0,585,585,851,585,1436,141500,138146.53976396783,129334.07490288018
364,554,918,918,728,1646,164000,184759.3836537929,175002.75035572032
365,75,440,694,0,694,90350,74138.1921375914,84807.46566083746
428,537,965,1940,1254,3194,359100,322747.19161534915,294803.63636707014
533,195,728,760,595,1355,140000,152137.89840216242,143716.46850091952
540,0,1560,1560,0,1560,201000,212414.13271687145,216093.8230646606
813,675,1488,1488,0,1488,215000,216572.2358445194,214619.7689716579
1219,816,2035,2515,0,2515,200624,348010.78200027096,367558.05401104473
548,311,859,942,886,1828,150909,201105.30443811335,194108.83362936263
0,961,961,1077,0,1077,67000,130260.89342569225,120482.42385580453
737,100,837,1001,0,1001,124900,133338.86782926007,122974.7781192833
1001,0,1001,1299,0,1299,183500,175196.59770650446,160292.86759414405
773,115,888,912,0,912,156000,129538.22523570087,125937.28635144126
336,748,1084,1080,0,1080,134000,145753.61592836576,137519.88755379786
224,98,852,918,0,918,148000,110758.01757871237,109740.24818895191
1102,328,1502,1502,0,1502,330000,224759.69936908523,232607.2033066901
0,1689,1689,1689,0,1689,231713,227203.51125468494,238006.83374692267
583,963,1546,1564,0,1564,267300,221306.92826323453,216476.01494026146
428,1048,1476,1484,0,1484,265900,206546.8722056572,199750.4988870699
215,970,1265,1240,0,1240,174000,167063.15035009198,159903.7790687707
902,254,1156,1187,530,1717,187500,217966.55711491374,207018.30126610064
250,1017,1267,1312,0,1312,180500,174896.04992997332,164285.43845506222
0,1491,1491,1491,0,1491,178000,198102.90211697272,198571.13495568064
206,914,1120,1120,0,1120,147000,148367.53075626917,139708.7723291209
16,0,920,936,0,936,140000,108504.27855967867,111830.76389493448
840,200,1040,1060,0,1060,129900,153089.82172639572,147645.9539331244
384,162,546,546,546,1092,93900,114949.38429400933,120285.07864018454
619,149,768,768,0,768,129500,106239.42951236706,109198.99637168169
1090,0,1090,1178,0,1178,135000,172146.88797555384,167520.59337688793
212,762,974,974,0,974,93500,127049.06489224543,121538.20686150817
0,1851,1851,1851,0,1851,192100,251013.1005491767,272633.1890893442
592,99,691,691,807,1498,187500,163471.81169480964,162013.87583296053
0,1074,1074,1074,990,2064,250000,221679.60314836385,221069.323765249
0,935,935,955,677,1632,176500,176152.91099172027,165593.4159969503
0,1191,1191,1204,0,1204,130000,155137.7622961392,147736.91669880616
495,354,1064,1064,703,1767,239000,205352.88510960096,195700.39784231244
0,1528,1528,1528,1862,3390,545224,363154.44537570525,415154.7769381195
1056,0,1056,1056,0,1056,145000,158732.13948186362,157058.97078701298
1191,523,1714,1714,0,1714,318000,258580.30314738592,275052.84778499446
213,995,1208,1621,0,1621,202500,197258.09841420437,177566.17639153366
850,138,988,1102,0,1102,169000,153826.68727029848,144390.11749681985
929,916,1845,1872,0,1872,241500,274079.7107432921,282374.8987670413
625,0,1686,1686,0,1686,207500,232572.53542103665,240398.28932214246
1005,42,1047,1083,0,1083,172000,159343.20327189585,155183.2803016494
548,127,675,1109,766,1875,184500,194196.41610874643,173969.27514974377
75,230,1096,1096,0,1096,138800,135286.6224861171,136929.41846060014
402,363,765,765,600,1365,125500,152184.0632524574,144709.04053446333
276,207,483,483,465,948,89000,96234.58994809145,109208.81673148162
373,462,943,1387,0,1387,145000,163830.24111448205,142203.35978286955
0,1721,1721,1740,0,1740,293000,233553.34399760346,246119.30065823754
1505,363,1868,1868,0,1868,415000,288517.70083630836,328348.48167149496
0,1030,1030,1038,1060,2098,275500,221906.65959024418,224525.28838510741
880,644,1524,1544,814,2358,329900,294932.3901966414,295762.79837598774
0,1085,1085,1120,850,1970,281000,214328.68690383015,206976.47602186294
1567,225,1792,1792,0,1792,374000,278789.88029844523,321247.0584376466
1410,438,1848,1848,880,2728,437154,358803.5359180541,389624.2418852098
472,1088,1560,1565,0,1565,282500,219656.01235463688,214909.3538050538
0,1368,1368,1368,0,1368,202665,180025.25098596967,176104.47019983392
1023,663,1686,1686,0,1686,332200,250557.41193185176,259052.9568240981
0,1405,1405,1405,0,1405,171750,185463.24360261287,182678.512996858
28,1288,1316,1316,0,1316,169990,173033.94236126734,167229.65298491545
0,728,728,728,728,1456,170440,148367.9739907881,147119.36499015664
0,879,879,879,984,1863,219210,192505.58295183702,194314.1608219563
0,1052,1052,1052,1321,2373,258000,246820.0395458077,264781.6209926663
0,738,738,738,754,1492,185101,152066.46236770897,150927.23447791545
453,767,1220,1364,0,1364,210250,181290.27212227217,167350.09365084363
1059,306,1365,1548,0,1548,225000,220076.86551263276,218561.1524971165
16,1232,1248,1248,0,1248,167240,162760.6756571108,156067.72582807238
16,1346,1362,1506,0,1506,213490,191995.85472457486,184075.86565328983
1182,358,1540,1540,1315,2855,405000,345521.55757062184,376284.94595267007
0,1100,1100,1116,848,1964,252000,214715.13138542173,207952.70530852574
1562,108,1670,1670,0,1670,336820,260742.90272777877,298357.05679304275
0,1616,1616,1616,0,1616,232000,216474.49879482132,223049.3414727541
0,1504,1504,1504,0,1504,199000,200013.54817146895,201044.0448130878
1836,200,2036,2036,604,2640,405749,372683.9588386644,439386.3092307453
0,858,858,858,858,1716,200825,178618.23774921554,175886.55009402608
905,357,1262,1262,0,1262,185000,185496.29457175508,182431.39852903737
0,1400,1400,1400,0,1400,186800,184728.37973549892,181780.53502396742
0,1131,1131,1131,0,1131,132000,145192.7036847687,138285.45958858586
941,217,1158,1158,0,1158,158000,171048.48047000563,167914.6733991517
0,891,891,891,795,1686,184000,178067.88079179614,172342.84429886774
0,941,941,941,896,1837,187000,194074.397344166,190783.23675352897
758,78,836,844,887,1731,248500,196195.0718198637,192642.5332507876
274,362,636,636,684,1320,150000,137447.92693307297,138754.3707571209
554,430,984,984,0,984,126000,136473.65880156896,130859.42940933074
712,312,1024,1024,0,1024,120875,146027.62487200423,140530.54165448435
644,268,912,912,0,912,124000,127985.00495067966,124809.18458959086
1012,326,1338,1352,1168,2520,310000,300491.1751439887,315869.7876993844
728,367,1095,1166,1129,2295,268000,259767.96691508358,263794.230007821
1456,168,1624,1624,0,1624,262000,251516.61183290317,280313.58382548316
0,1143,1143,1143,0,1143,176400,146956.37696584218,140005.8974762903
0,600,600,520,623,1223,149900,110569.45579530965,121885.26686195354
353,403,756,768,756,1524,166000,164134.1634343376,159551.99255364732
641,32,673,673,709,1382,165000,153565.32086975523,149922.65589632862
437,0,1494,1494,0,1494,270000,200013.8152795834,202341.61352622436
767,441,1208,1208,0,1208,165000,174349.90652574558,168320.64818802502
1009,44,1235,1235,0,1235,214000,182449.97738831295,180983.0443410025
297,1203,1568,2156,0,2156,262500,266729.78703971184,257926.5391039583
619,435,1054,1512,1142,2654,250000,285861.9009672194,276015.10413882433
0,1164,1164,1164,0,1164,140000,150042.80520772072,143069.78223627075
400,100,980,980,0,980,135500,128355.41981325476,125315.98578619675
760,216,976,976,0,976,157500,140089.40419333783,135814.4059966661
602,137,1141,1141,0,1141,158000,157358.12851438584,151927.53398595445
915,135,1050,1050,0,1050,136500,154570.6650322962,150938.26025516036
901,34,1187,1565,0,1565,185900,205068.16543082715,190523.16130610515
360,360,720,720,720,1440,157500,154879.96264016774,151601.9450306586
632,616,1248,1248,0,1248,151500,177088.73870932986,169250.52660933833
574,242,816,816,0,816,129800,112247.42971888519,112907.90068806754
486,522,1008,1008,0,1008,137000,138419.33606574367,131926.35211936667
756,1380,2136,2136,0,2136,137900,310484.78199330403,320838.741425851
0,704,704,1024,704,1728,137000,170517.27190623392,155670.46804235998
0,1584,1584,1584,0,1584,119000,211771.3700452921,216639.4780985449
623,556,1179,1364,0,1364,132000,182771.97553734,168683.85161705472
203,918,1121,1336,0,1336,162000,167078.47971650845,150634.03420260223
360,710,1070,1236,0,1236,134450,158987.90063253295,143956.3079478245
0,1367,1367,1375,0,1375,140000,180571.62726239502,176403.70980252203
658,350,1008,1008,0,1008,139500,142420.0289959087,136809.87786472097
741,143,884,884,0,884,142000,126125.9720287137,124064.68252382305
1018,1153,2171,1392,1248,2640,180000,361188.5549491206,404383.44057000766
0,784,784,900,412,1312,127000,139563.99656022427,126860.93101641018
0,1073,1073,1073,0,1073,108480,136668.28282624693,130289.59768416057
0,672,672,694,520,1214,105000,124214.12342465043,122464.18569037132
600,312,912,1085,649,1734,159000,197588.53958263056,179896.73586804682
701,434,1135,1207,0,1207,147000,168325.88590177725,158619.6051755235
1277,207,1484,1600,0,1600,207500,236830.4729480247,248909.31061903216
0,686,686,810,518,1328,107000,134940.49951177198,126634.72258195936
381,399,780,940,476,1416,156500,157137.70532141766,140585.3975062911
16,712,728,832,809,1641,178000,164697.1157383099,160429.51811785562
208,504,712,848,580,1428,139900,149954.59937711328,138800.8811899416
143,817,1032,1032,0,1032,108000,133376.3067904425,127564.33105251628
0,576,576,864,0,864,105000,88583.38022965306,89020.82228621448
310,460,770,885,297,1182,120000,134772.28054666083,122050.09613155814
0,798,798,840,0,840,64000,99890.85264668259,101021.97208524862
0,1095,1095,1095,679,1774,87000,198106.62524110725,187058.66614737388
0,815,815,815,875,1690,144000,173755.67506610413,173063.97773458782
0,596,596,998,764,1762,157000,166894.33392834588,155437.95634908852
0,960,960,960,0,960,125000,120060.35942947179,116312.77644681
0,1020,1020,1020,0,1020,64500,128878.72583483913,123462.5518389484
0,896,896,896,448,1344,115000,149057.3622352769,137823.93567558716
347,381,728,728,434,1162,75000,131236.9998039032,125343.93774831571
489,279,768,1015,0,1015,88000,124622.80188618667,112604.87802026603
0,0,0,672,240,912,80500,57780.99229415608,93005.36610709269
397,706,1103,1103,0,1103,110500,150311.6235479744,141669.14557130486
0,596,596,834,596,1430,107000,138279.4557921356,130248.7469483816
0,396,396,665,665,1330,116500,117486.41653519368,124642.53220065191
0,780,780,780,596,1376,119500,144695.31186894726,138649.6170226649
0,803,803,803,557,1360,125500,144732.5446936319,137289.1760040832
343,641,984,984,0,984,90000,131565.8320093316,125510.81533880718
0,0,0,1640,0,1640,131000,121103.05216245851,123994.4369413733
0,0,0,1032,0,1032,125000,68408.52437400159,89837.71122676802
0,830,830,879,0,879,80000,105200.66181482896,104070.92539486995
510,190,1073,1073,0,1073,157000,145462.61946713246,140564.5229356055
663,396,1059,1068,0,1068,154500,150811.9573346363,143927.86617188656
209,463,672,672,728,1400,149500,144998.80578611483,145450.5282071888
194,0,1176,1458,0,1458,165000,172681.81247785117,162720.91341833663
168,284,1134,1803,0,1803,155000,201912.6679546787,185792.61459472563
306,372,1763,1779,0,1779,170000,237658.83067281006,251244.29317822235
603,701,1304,1304,983,2287,225000,268908.9751915367,267932.97714605846
762,102,864,894,0,894,142500,126275.03219215041,122955.78783794204
397,33,430,880,680,1700,148400,143349.93406250962,134138.0593149395
230,569,799,799,351,1150,128000,131835.77538672285,123680.7198134307
603,293,896,1112,896,2008,225000,220206.7319842346,208365.05877784337
0,672,672,1337,672,2009,235000,192971.73090962874,168163.15694890753
0,0,0,1124,0,1124,93000,76382.03844725495,93489.58867516075
1258,40,1298,1298,0,1298,180000,198998.03885886076,206763.5441587388
549,319,868,1313,1246,2559,209000,264685.1264921427,261608.68774944343
0,1498,1498,1498,0,1498,204900,199131.71153093223,199900.48859116872
1576,260,1836,1846,0,1846,233555,286332.7072249133,330768.3172526209
1300,434,1734,1734,0,1734,260000,264055.08146112075,286859.8121697379
1122,448,1570,1590,0,1590,294900,237544.66725853516,246969.95047334261
812,812,1624,1582,0,1582,190000,232897.1906756989,234338.77355737038
938,0,938,988,0,988,180000,142978.1223506911,137679.96686855468
853,535,1388,1388,0,1388,158900,202805.35220693005,200127.02778771007
716,274,990,990,0,990,156000,141123.5899460984,136271.0777262021
1200,279,1479,1494,0,1494,217000,225551.06944505093,235923.33511045875
500,342,842,856,893,1749,196000,192110.21023162195,188641.7859995553
0,936,936,936,840,1776,192500,188539.1259389441,183289.86777832254
523,448,971,971,0,971,128500,133841.9576259383,128473.96004139204
437,427,864,864,0,864,119900,116115.52440461735,114672.5032364811
685,245,930,950,1045,1995,237000,222896.57456783848,224723.0348573873
975,133,1108,1108,989,2097,274300,249269.3024333659,252631.96744723848
717,131,848,848,0,848,133000,120276.71596267959,119410.67244661119
24,1528,1552,1552,0,1552,212900,207626.4775185766,210047.86943252466
0,728,728,728,728,1456,163990,148367.9739907881,147119.36499015664
836,0,836,1220,0,1220,102000,154561.71834576715,134306.83563625242
847,329,1176,1176,0,1176,119900,171507.56518559536,166738.55112618324
0,796,796,806,918,1724,196500,175515.90590014274,176734.32920812385
475,142,914,914,0,914,117250,121905.00658880401,119694.54376773699
0,970,970,970,739,1709,130000,184878.3223540885,176004.6367096571
0,976,976,976,732,1708,130000,185160.10805236173,176021.14888377071
0,658,658,658,526,1184,81000,120764.12408873206,121334.07998328289
0,616,616,1055,218,1273,121000,126236.55525579664,109110.52849069046
930,128,1058,1058,493,1551,137000,198356.07550692314,187311.94216556565
780,0,780,816,524,1340,128000,159786.10728571404,147722.27978086576
305,450,755,755,755,1510,149000,161744.9730773347,158017.8773061717
0,817,817,940,610,1550,195000,161993.64801153226,148986.51690239616
602,299,901,1125,592,1717,194000,195552.3298517077,175259.7663380773
0,697,697,1104,697,1801,210000,176428.58246710914,158682.9628036818
296,230,1073,1811,0,1811,230000,203015.19259783876,182009.0420435169
760,408,1168,1278,1037,2315,257000,266734.98714410246,265747.33879595867
374,487,861,861,424,1285,145400,150555.17878799458,138871.70600789913
0,967,967,967,671,1638,139000,178608.3377375462,168175.51537102624
0,660,660,1060,336,1396,115000,139438.42512368865,120249.60439524545
0,216,216,576,360,936,78000,72773.08599106179,95447.76592561345
1573,0,1573,1778,0,1778,375000,264509.4713769159,295814.4390732933
0,0,0,1295,0,1295,230000,91202.37438775846,101905.38258760743
1053,256,1309,1339,0,1339,180000,198446.53056690795,198953.32770039083
1350,378,1728,1960,0,1960,320000,284443.3593970414,307891.9509239581
1460,408,1868,2028,0,2028,369900,301337.988915495,336634.27464924665
1201,36,1237,1337,0,1337,153500,197373.75177398947,198431.32687122983
0,1140,1140,1140,0,1140,84500,146515.45864557382,139573.70374081712
548,36,757,925,550,1475,127000,163255.42526922468,146180.01696454518
837,105,942,1291,1230,2521,151400,272568.2127901284,272552.3704136936
149,1503,1652,1652,0,1652,146500,225231.2351880103,228363.51558688332
522,108,630,630,0,630,73000,83700.98204615005,96674.71723991855
119,641,1104,1360,0,1360,140000,163349.8916413206,151011.87186528638
0,546,546,546,546,1092,79500,106017.60472898968,115673.78295655249
252,294,546,546,546,1092,71000,111879.08506853384,118923.04608649132
936,396,1728,1728,0,1728,150900,251449.28809936525,262918.1937840583
819,184,1003,1003,0,1003,142500,145429.9997901702,141175.26897671242
1071,195,1389,1389,0,1389,170000,207011.2105621965,210993.7226597773
758,238,996,996,1004,2000,188000,229046.78940978026,229748.53473085212
